,Class,Present,Absent,Leave,Total
0,Nursery,58,22,0,80
1,I,50,24,0,74
2,II,56,22,0,78
3,III,70,11,0,81
4,IV,69,9,0,78
5,V,66,16,0,82
6,VI,202,106,0,308
7,VII,197,96,0,293
8,VIII,202,108,0,310
9,IX,286,119,0,405
10,X,112,24,0,136
11,XI Science,0,0,0,0
12,XI Arts,119,38,0,157
13,XI Commerce,13,7,1,21
14,XI Vocational,0,0,0,0
15,XII Science,0,0,0,0
16,XII Arts,125,1,0,126
17,XII Commerce,0,0,0,0
18,XII Vocational,0,0,0,0
