,Class,Present,Absent,Leave,Total
0,Nursery,0,0,0,0
1,I,0,0,0,0
2,II,0,0,0,0
3,III,0,0,0,0
4,IV,0,0,0,0
5,V,0,0,0,0
6,VI,207,98,3,308
7,VII,216,77,0,293
8,VIII,252,58,1,311
9,IX,290,111,4,405
10,X,115,20,0,135
11,XI Science,0,0,0,0
12,XI Arts,125,31,1,157
13,XI Commerce,17,4,0,21
14,XI Vocational,0,0,0,0
15,XII Science,0,0,0,0
16,XII Arts,54,72,0,126
17,XII Commerce,0,0,0,0
18,XII Vocational,0,0,0,0
