,Class,Present,Absent,Leave,Total
0,Nursery,19,61,0,80
1,I,27,47,0,74
2,II,25,53,0,78
3,III,33,45,1,79
4,IV,41,37,0,78
5,V,50,32,0,82
6,VI,177,129,0,306
7,VII,189,116,0,305
8,VIII,211,104,0,315
9,IX,238,166,1,405
10,X,94,41,0,135
11,XI Science,0,0,0,0
12,XI Arts,111,44,2,157
13,XI Commerce,16,2,3,21
14,XI Vocational,0,0,0,0
15,XII Science,0,0,0,0
16,XII Arts,84,42,0,126
17,XII Commerce,16,7,0,23
18,XII Vocational,0,0,0,0
