,Class,Present,Absent,Leave,Total
0,Nursery,0,0,0,0
1,I,0,0,0,0
2,II,0,0,0,0
3,III,77,2,0,79
4,IV,78,0,0,78
5,V,82,0,0,82
6,VI,225,76,3,304
7,VII,210,82,0,292
8,VIII,227,79,1,307
9,IX,236,160,0,396
10,X,97,38,0,135
11,XI Science,0,0,0,0
12,XI Arts,58,95,3,156
13,XI Commerce,5,4,12,21
14,XI Vocational,0,0,0,0
15,XII Science,0,0,0,0
16,XII Arts,0,0,0,0
17,XII Commerce,0,0,0,0
18,XII Vocational,0,0,0,0
