,Class,Present,Absent,Leave,Total
0,Nursery,0,0,0,0
1,I,0,0,0,0
2,II,0,0,0,0
3,III,0,0,0,0
4,IV,0,0,0,0
5,V,0,0,0,0
6,VI,245,61,0,306
7,VII,209,82,1,292
8,VIII,250,57,0,307
9,IX,261,134,1,396
10,X,92,43,0,135
11,XI Science,0,0,0,0
12,XI Arts,151,5,0,156
13,XI Commerce,21,0,0,21
14,XI Vocational,0,0,0,0
15,XII Science,0,0,0,0
16,XII Arts,0,0,0,0
17,XII Commerce,0,0,0,0
18,XII Vocational,0,0,0,0
