,Class,Present,Absent,Leave,Total
0,Nursery,67,14,1,82
1,I,70,7,0,77
2,II,69,10,0,79
3,III,66,13,0,79
4,IV,74,5,0,79
5,V,70,10,0,80
6,VI,231,54,2,287
7,VII,222,61,3,286
8,VIII,200,79,2,281
9,IX,402,88,3,493
10,X,130,24,2,156
11,XI Science,0,0,0,0
12,XI Arts,106,21,2,129
13,XI Commerce,20,1,0,21
14,XI Vocational,0,0,0,0
15,XII Science,0,0,0,0
16,XII Arts,116,1,0,117
17,XII Commerce,20,0,0,20
18,XII Vocational,0,0,0,0
