,Class,Present,Absent,Leave,Total
0,Nursery,49,32,1,82
1,I,35,42,0,77
2,II,38,41,0,79
3,III,64,15,0,79
4,IV,68,10,1,79
5,V,73,7,0,80
6,VI,230,57,0,287
7,VII,239,47,0,286
8,VIII,238,43,0,281
9,IX,414,74,5,493
10,X,131,23,2,156
11,XI Science,0,0,0,0
12,XI Arts,104,22,3,129
13,XI Commerce,15,6,0,21
14,XI Vocational,0,0,0,0
15,XII Science,0,0,0,0
16,XII Arts,79,37,1,117
17,XII Commerce,10,9,1,20
18,XII Vocational,0,0,0,0
