,Class,Present,Absent,Leave,Total
0,Nursery,30,51,1,82
1,I,22,55,0,77
2,II,20,59,0,79
3,III,64,15,0,79
4,IV,67,12,0,79
5,V,66,14,0,80
6,VI,212,74,1,287
7,VII,222,63,3,288
8,VIII,219,63,0,282
9,IX,388,93,12,493
10,X,129,26,1,156
11,XI Science,0,0,0,0
12,XI Arts,99,29,1,129
13,XI Commerce,19,2,0,21
14,XI Vocational,0,0,0,0
15,XII Science,0,0,0,0
16,XII Arts,84,30,3,117
17,XII Commerce,16,3,1,20
18,XII Vocational,0,0,0,0
