,Class,Present,Absent,Leave,Total
0,Nursery,63,18,1,82
1,I,61,16,0,77
2,II,58,21,0,79
3,III,66,13,0,79
4,IV,69,9,1,79
5,V,67,13,0,80
6,VI,235,51,2,288
7,VII,247,40,1,288
8,VIII,191,92,0,283
9,IX,311,178,4,493
10,X,126,25,5,156
11,XI Science,0,0,0,0
12,XI Arts,108,22,0,130
13,XI Commerce,19,2,0,21
14,XI Vocational,0,0,0,0
15,XII Science,0,0,0,0
16,XII Arts,96,19,2,117
17,XII Commerce,20,0,0,20
18,XII Vocational,0,0,0,0
