,Class,Present,Absent,Leave,Total
0,Nursery,60,21,1,82
1,I,56,21,0,77
2,II,56,23,0,79
3,III,60,19,0,79
4,IV,66,13,0,79
5,V,68,12,0,80
6,VI,0,288,0,288
7,VII,0,288,0,288
8,VIII,0,283,0,283
9,IX,471,22,0,493
10,X,146,10,0,156
11,XI Science,0,0,0,0
12,XI Arts,123,6,0,129
13,XI Commerce,21,0,0,21
14,XI Vocational,0,0,0,0
15,XII Science,0,0,0,0
16,XII Arts,109,8,0,117
17,XII Commerce,20,0,0,20
18,XII Vocational,0,0,0,0
