,Class,Present,Absent,Leave,Total
0,Nursery,65,16,1,82
1,I,62,15,0,77
2,II,67,12,0,79
3,III,63,16,0,79
4,IV,72,7,0,79
5,V,73,7,0,80
6,VI,247,39,2,288
7,VII,246,40,2,288
8,VIII,243,40,0,283
9,IX,419,67,7,493
10,X,130,24,2,156
11,XI Science,0,0,0,0
12,XI Arts,104,24,1,129
13,XI Commerce,21,0,0,21
14,XI Vocational,0,0,0,0
15,XII Science,0,0,0,0
16,XII Arts,80,37,0,117
17,XII Commerce,10,2,8,20
18,XII Vocational,0,0,0,0
